22222222222222222222222222222
22+++++++++2++2+22+2+222+2++2+2+2+++++++++++++++++++++++++++++++++++++++++++++++++++++++++++++++++%
2+++++++++++22+2++2+2+2+2+2++2+++++++2+++++++++++++++++++++++++++++++++++++++++++++++++1++++++++++%
2+++++++++2+22+22+2+2+222++22+2+++++++++++++++++++++++++++++++++++++++++++++++++++++++++++++++++++%
222+2+22+222+2+2++2+2+2+++++++++++++++++++++++++++++++++++++++++++++++++++++++++++++++++++++++++++%
#2+222+222+222++222++2++++++2+++++++++++++++++++++++++++++++++++++++++++++++++++++++++++++++++++++%
#2222+22+2+2++2++++22+++++++++++++++++++++++++++++++++1++++++++++2++++++++++++++++++++++++++++++++%
#2+22++++++++++++++++++++++++++++++++++++1++++++++++++++++++++++++++++++++++++++++++++++++++++++++%
#+++++++2+++++22++++++++++++++++++++++++++++++++++++++++++++++++++++++++++++++++++++++++++++++++++%
#+++++++++++++++++++++++++++++++++++++++++++++++++++++++++++++++++++++++++++++++++++++++++++++++++%
#++++++++++++++++++++++++++++++++++++++++++++++++++++++++++++++++2++++++++++++++++++++++++++++++++%
#+++++++++++++++++++++++++++++++++++++++++++++++++++++++++++++++++++++2+++++++++++++++++++++++++++%
#+++++++++++++++++++++++++++++++++++++++++++++++++++++++++++++++++++++++++++++++++++++++++++++++++%
#+++++++++++++++++++++++++++++++++++++++++++++++++++++++++++++++++++++++++++++++++++++++++++++++++%
#+++++++++++++++++++++++++++++++++++++++++++++++++++++++++++++++++++++++++++++++++++++++++++++++++%
#+++++++++++++++++++++++++++++++++++++++++++++++++++++++++++++++++++++++++++++++++++++++++++++++++%
#+1+++++++++++++++++++++++++++++++++2+++++++++++++++++1+++++++++++++++++++++++++++++++++1+++++++++%
#++++++++++++2++++++++++++++++++++++++++++++++++++++++++++++++++++++++++++++++++++++++++++++++++++%
#+++++++++++++++++++++++++++++++++++++++++++++++++++++++++++++++++++++++++++++++++++++++++++++++++%
#+++++++++++++++++++++++++++++++++++++++++++++++++++++++++++++++++++++++++++++++++++++++++++++++++%
#+++++++++++++++++++++++++++++++++++++++++++++++++++++++++++++++1+++++++++++++++++++++++++++++++++%
#+++++++++++++++++++++++++++++++++++++++++++++++++++++++++++++++++++++++++++++++++++++++++++++++++%
#+++++++++++++++++++++++++++++++++++++++++++++++++++++++++++++++++++++++++++++++++++++++++++++++++%
#+++++++++++++++++++++++++++++++++++++++++++++++++++++++++++++++++++++++++++++++++++++++++++++++++%
#++++++++++++++++++++++++++++++++++++++++++++++++++++++++++++++++++++++2++++++++++++++++++++++++++%
#+++++++++++++++++++++++++++++++++++++++++++++++++++++++++++++++++++++++++++++++++++++++++++++++++%
#+++++++++++++++++++++++++++++++++++++++++++++++++++++++++++++++++++++++++++++++++++++++++++++++++%
#+++++++++++++++++++++++++++++++++++++++++++++++++++++++++++++++++++++++++++++++++++++++++++++++++%
#++++++++++++++++++++++++++++++++++++++2+++++++++++++++++++++%%%%%%%%%%%%%%%%%%%%%%%%%%%%%%%%%%%%%%
#++++++++++++1++++++++++++++++++++++++++++++++++++++++1++++++%%%%%%%%%%%%%%%%%%%%%%%%%%%%%%%%%%%%%%
#++++++++++++++++++++++++++++++++++++++++++++++++++++++++++++%%%%%%%%%%%%%%%%%%%%%%%%%%%%%%%%%%%%%%
#++++++++++++++++++++++++++++++++++++++++++++++++++++++++++++%%%%%%1%%%%%%%%%%%%%%%%%%%%%%%%%%%%%%
#+++++++++++++++++++++++++++++++++++++++++++++++++++++++++++++%%+2%%%%%%%%%%%%%%%%%%%%%%%%%%%%%%%%
%%%%%%%%%%%%%%%%%%%%%%%%%%%%%%%%%%%%%%%%%%%%%%%%%%%%%%%%%%%%%%%%%%%%%%%%%%%%%%%%%%%%%%%%%%%%%%%%%%%